# dimensions of scene, in number of cells
DIMENSIONS 16 16
# height of walls
HEIGHT 10
# cell size
CELL 10

# textures.  the last one is always the texture of the floor
TEXTURES 9  # number of textures
1 data\wall1.ppm
2 data\wall2.ppm
3 data\wall3.ppm
4 data\wall4.ppm
5 data\wall5.ppm
6 data\wall6.ppm
7 data\wall7.ppm
8 data\monaLisa.ppm
9 data\floor.ppm

FLOORPLAN
# floor plan, indicating which walls have which textures
# +___+___+___+___+___+___+___+___+___+___+___+___+___+___+___+___
    1   2   1   2   1   2   1   2   1   2   1   2   1   2   1   0 # +
  1   0   0   0   0   0   0   0   0   0   0   0   0   0   0   5   # |
    0   1   1   1   1   1   1   1   1   0   1   1   1   1   1   0 # +
  7   1   0   0   0   0   0   0   0   1   1   0   0   0   0   6   # |
    0   0   0   1   0   1   0   1   0   0   1   1   0   1   0   0 # +
  1   1   1   1   1   1   1   1   1   1   0   0   0   1   0   5   # |
    0   0   1   0   1   0   1   0   1   1   1   1   0   0   1   0 # +
  7   1   0   0   0   0   0   0   0   0   0   0   1   1   0   6   # |
    0   1   2   1   2   1   2   1   2   1   0   0   0   1   0   0 # +
  1   0   0   0   0   0   0   0   0   0   0   1   1   1   0   5   # |
    1   1   2   1   2   1   0   1   2   1   0   0   0   1   1   0 # +
  7   0   0   0   0   0   1   1   0   0   1   1   1   0   0   6   # |
    0   1   1   1   1   0   1   0   1   0   0   0   1   1   0   0 # +
  1   1   0   0   0   1   1   0   0   1   0   1   0   0   1   5   # |
    0   0   0   0   0   0   0   0   0   1   1   1   1   1   0   0 # +
  7   1   0   0   0   1   0   0   0   0   0   1   0   0   1   6   # |
    0   0   0   0   0   0   0   0   0   1   0   0   1   1   0   0 # +
  1   0   0   0   0   1   1   0   0   1   1   1   0   0   1   5   # |
    1   1   1   0   1   0   1   0   1   0   0   1   1   0   0   0 # +
  7   0   0   0   1   0   0   0   0   0   1   0   0   0   1   6   # |
    0   0   0   0   0   1   1   8   1   1   1   1   1   1   0   0 # +
  1   0   0   0   1   1   0   0   0   0   0   0   0   0   1   5   # |
    1   1   0   1   0   0   0   0   0   1   1   1   1   0   0   0 # +
  7   0   0   0   1   1   1   4   4   1   0   1   0   1   1   6   # |
    0   0   0   0   0   0   0   0   0   0   0   0   0   0   0   0 # +
  1   0   1   0   1   1   1   4   4   1   0   1   1   1   1   5   # |
    1   3   0   3   0   0   0   0   0   1   0   0   0   0   0   0 # +
  7   0   0   0   0   1   1   4   4   0   1   1   1   1   1   6   # |
    1   3   1   3   1   0   0   0   0   0   0   0   0   1   0   0 # +
  1   0   0   0   0   0   0   4   4   0   0   0   1   0   0   5   # |
    1   1   1   1   1   1   1   0   1   1   1   1   1   1   1   0 # +
  0   0   0   0   0   0   0   0   0   0   0   0   0   0   0   0   # |

# end of the file












